;level 0
w32
h32
[0,0][0,0][0,0][0,0][0,0][0,0][0,0][0,0][0,0][0,0][0,0][0,0][0,0][0,0][0,0][0,0][0,0][0,0][0,0][0,0][0,0][0,0][0,0][0,0][0,0][0,0][0,0][0,0][0,0][0,0][0,0][0,0]
[1,0][0,1][1,0][1,0][1,0][1,0][1,0][1,0][1,0][1,0][1,0][0,1][0,0][0,0][0,0][0,0][0,0][0,0][0,0][0,0][0,0][0,0][0,0][0,0][0,0][0,0][0,0][0,0][0,0][0,0][0,0][0,0]
[0,0][1,0][0,-1][0,0][0,0][0,0][0,0][0,0][0,0][0,0][0,0][0,1][0,0][0,0][0,0][0,0][0,0][0,0][0,0][0,0][0,0][0,0][0,0][0,0][0,0][0,0][0,0][0,0][0,0][0,0][0,0][0,0]
[0,0][0,0][0,0][0,0][0,0][0,0][0,0][0,0][0,0][0,0][0,0][0,1][0,0][0,0][0,0][0,0][0,0][0,0][0,0][0,0][0,0][0,0][0,0][0,0][0,0][0,0][0,0][0,0][0,0][0,0][0,0][0,0]
[0,0][0,0][0,0][0,0][0,0][0,0][0,0][0,0][0,0][0,0][0,0][0,1][0,0][0,0][0,0][0,0][0,0][0,0][0,0][0,0][0,0][0,0][0,0][0,0][0,0][0,0][0,0][0,0][0,0][0,0][0,0][0,0]
[0,0][0,0][0,0][0,0][0,0][0,0][0,0][0,0][0,0][0,0][0,0][0,1][0,0][0,0][0,0][0,0][0,0][0,0][0,0][0,0][0,0][0,0][0,0][0,0][0,0][0,0][0,0][0,0][0,0][0,0][0,0][0,0]
[0,0][0,0][0,0][0,0][0,0][0,0][0,0][0,0][0,0][0,1][-1,0][-1,0][0,0][0,0][0,0][0,0][0,0][0,0][0,0][0,0][0,0][0,0][0,0][0,0][0,0][0,0][0,0][0,0][0,0][0,0][0,0][0,0]
[0,0][0,0][0,0][0,0][0,0][0,0][0,0][0,0][0,0][0,1][0,0][0,0][0,0][0,0][0,0][0,0][0,0][0,0][0,0][0,0][0,0][0,0][0,0][0,0][0,0][0,0][0,0][0,0][0,0][0,0][0,0][0,0]
[0,0][0,0][0,0][0,0][0,0][0,0][0,0][0,0][0,0][1,0][1,0][1,0][1,0][1,0][1,0][1,0][1,0][1,0][1,0][1,0][1,0][1,0][1,0][0,1][0,0][0,0][0,0][0,0][0,0][0,0][0,0][0,0]
[0,0][0,0][0,0][0,0][0,0][0,0][0,0][0,0][0,0][0,0][0,0][0,0][0,0][0,0][0,0][0,0][0,0][0,0][0,0][0,0][0,0][0,0][0,0][1,0][1,0][1,0][1,0][1,0][1,0][1,0][1,0][1,0]
[0,0][0,0][0,0][0,0][0,0][0,0][0,0][0,0][0,0][0,0][0,0][0,0][0,0][0,0][0,0][0,0][0,0][0,0][0,0][0,0][0,0][0,0][0,0][0,0][0,0][0,0][0,0][0,0][0,0][0,0][0,0][0,0]
[0,0][0,0][0,0][0,0][0,0][0,0][0,0][0,0][0,0][0,0][0,0][0,0][0,0][0,0][0,0][0,0][0,0][0,0][0,0][0,0][0,0][0,0][0,0][0,0][0,0][0,0][0,0][0,0][0,0][0,0][0,0][0,0]
[0,0][0,0][0,0][0,0][0,0][0,0][0,0][0,0][0,0][0,0][0,0][0,0][0,0][0,0][0,0][0,0][0,0][0,0][0,0][0,0][0,0][0,0][0,0][0,0][0,0][0,0][0,0][0,0][0,0][0,0][0,0][0,0]
[0,0][0,0][0,0][0,0][0,0][0,0][0,0][0,0][0,0][0,0][0,0][0,0][0,0][0,0][0,0][0,0][0,0][0,0][0,0][0,0][0,0][0,0][0,0][0,0][0,0][0,0][0,0][0,0][0,0][0,0][0,0][0,0]
[0,0][0,0][0,0][0,0][0,0][0,0][0,0][0,0][0,0][0,0][0,0][0,0][0,0][0,0][0,0][0,0][0,0][0,0][0,0][0,0][0,0][0,0][0,0][0,0][0,0][0,0][0,0][0,0][0,0][0,0][0,0][0,0]
[0,0][0,0][0,0][0,0][0,0][0,0][0,0][0,0][0,0][0,0][0,0][0,0][0,0][0,0][0,0][0,0][0,0][0,0][0,0][0,0][0,0][0,0][0,0][0,0][0,0][0,0][0,0][0,0][0,0][0,0][0,0][0,0]
[0,0][0,0][0,0][0,0][0,0][0,0][0,0][0,0][0,0][0,0][0,0][0,0][0,0][0,0][0,0][0,0][0,0][0,0][0,0][0,0][0,0][0,0][0,0][0,0][0,0][0,0][0,0][0,0][0,0][0,0][0,0][0,0]
[0,0][0,0][0,0][0,0][0,0][0,0][0,0][0,0][0,0][0,0][0,0][0,0][0,0][0,0][0,0][0,0][0,0][0,0][0,0][0,0][0,0][0,0][0,0][0,0][0,0][0,0][0,0][0,0][0,0][0,0][0,0][0,0]
[0,0][0,0][0,0][0,0][0,0][0,0][0,0][0,0][0,0][0,0][0,0][0,0][0,0][0,0][0,0][0,0][0,0][0,0][0,0][0,0][0,0][0,0][0,0][0,0][0,0][0,0][0,0][0,0][0,0][0,0][0,0][0,0]
[0,0][0,0][0,0][0,0][0,0][0,0][0,0][0,0][0,0][0,0][0,0][0,0][0,0][0,0][0,0][0,0][0,0][0,0][0,0][0,0][0,0][0,0][0,0][0,0][0,0][0,0][0,0][0,0][0,0][0,0][0,0][0,0]
[0,0][0,0][0,0][0,0][0,0][0,0][0,0][0,0][0,0][0,0][0,0][0,0][0,0][0,0][0,0][0,0][0,0][0,0][0,0][0,0][0,0][0,0][0,0][0,0][0,0][0,0][0,0][0,0][0,0][0,0][0,0][0,0]
[0,0][0,0][0,0][0,0][0,0][0,0][0,0][0,0][0,0][0,0][0,0][0,0][0,0][0,0][0,0][0,0][0,0][0,0][0,0][0,0][0,0][0,0][0,0][0,0][0,0][0,0][0,0][0,0][0,0][0,0][0,0][0,0]
[0,0][0,0][0,0][0,0][0,0][0,0][0,0][0,0][0,0][0,0][0,0][0,0][0,0][0,0][0,0][0,0][0,0][0,0][0,0][0,0][0,0][0,0][0,0][0,0][0,0][0,0][0,0][0,0][0,0][0,0][0,0][0,0]
[0,0][0,0][0,0][0,0][0,0][0,0][0,0][0,0][0,0][0,0][0,0][0,0][0,0][0,0][0,0][0,0][0,0][0,0][0,0][0,0][0,0][0,0][0,0][0,0][0,0][0,0][0,0][0,0][0,0][0,0][0,0][0,0]
[0,0][0,0][0,0][0,0][0,0][0,0][0,0][0,0][0,0][0,0][0,0][0,0][0,0][0,0][0,0][0,0][0,0][0,0][0,0][0,0][0,0][0,0][0,0][0,0][0,0][0,0][0,0][0,0][0,0][0,0][0,0][0,0]
[0,0][0,0][0,0][0,0][0,0][0,0][0,0][0,0][0,0][0,0][0,0][0,0][0,0][0,0][0,0][0,0][0,0][0,0][0,0][0,0][0,0][0,0][0,0][0,0][0,0][0,0][0,0][0,0][0,0][0,0][0,0][0,0]
[0,0][0,0][0,0][0,0][0,0][0,0][0,0][0,0][0,0][0,0][0,0][0,0][0,0][0,0][0,0][0,0][0,0][0,0][0,0][0,0][0,0][0,0][0,0][0,0][0,0][0,0][0,0][0,0][0,0][0,0][0,0][0,0]
[0,0][0,0][0,0][0,0][0,0][0,0][0,0][0,0][0,0][0,0][0,0][0,0][0,0][0,0][0,0][0,0][0,0][0,0][0,0][0,0][0,0][0,0][0,0][0,0][0,0][0,0][0,0][0,0][0,0][0,0][0,0][0,0]
[0,0][0,0][0,0][0,0][0,0][0,0][0,0][0,0][0,0][0,0][0,0][0,0][0,0][0,0][0,0][0,0][0,0][0,0][0,0][0,0][0,0][0,0][0,0][0,0][0,0][0,0][0,0][0,0][0,0][0,0][0,0][0,0]
[0,0][0,0][0,0][0,0][0,0][0,0][0,0][0,0][0,0][0,0][0,0][0,0][0,0][0,0][0,0][0,0][0,0][0,0][0,0][0,0][0,0][0,0][0,0][0,0][0,0][0,0][0,0][0,0][0,0][0,0][0,0][0,0]
[0,0][0,0][0,0][0,0][0,0][0,0][0,0][0,0][0,0][0,0][0,0][0,0][0,0][0,0][0,0][0,0][0,0][0,0][0,0][0,0][0,0][0,0][0,0][0,0][0,0][0,0][0,0][0,0][0,0][0,0][0,0][0,0]
[0,0][0,0][0,0][0,0][0,0][0,0][0,0][0,0][0,0][0,0][0,0][0,0][0,0][0,0][0,0][0,0][0,0][0,0][0,0][0,0][0,0][0,0][0,0][0,0][0,0][0,0][0,0][0,0][0,0][0,0][0,0][0,0]

;level 1
w32
h32
[0,0][0,0][0,0][0,0][0,0][0,0][0,0][0,0][0,0][0,0][0,0][0,0][0,0][0,0][0,0][0,0][0,0][0,0][0,0][0,0][0,0][0,0][0,0][0,0][0,0][0,0][0,0][0,0][0,0][0,0][0,0][0,0]
[1,0][0,1][0,0][0,0][0,0][0,0][0,0][0,0][0,0][0,0][0,0][0,0][0,0][0,0][0,0][0,0][0,0][0,0][0,0][0,0][0,0][0,0][0,0][0,0][0,0][0,0][0,0][0,0][0,0][0,0][0,0][0,0]
[0,0][0,1][0,0][0,0][0,0][0,0][0,0][0,0][0,0][0,0][0,0][0,0][0,0][0,0][0,0][0,0][0,0][0,0][0,0][0,0][0,0][0,0][0,0][0,0][0,0][0,0][0,0][0,0][0,0][0,0][0,0][0,0]
[0,0][0,1][0,0][0,0][0,0][0,0][0,0][0,0][0,0][0,0][0,0][0,0][0,0][0,0][0,0][0,0][0,0][0,0][0,0][0,0][0,0][0,0][0,0][0,0][0,0][0,0][0,0][0,0][0,0][0,0][0,0][0,0]
[0,0][0,1][0,0][0,0][0,0][0,0][0,0][0,0][0,0][0,0][0,0][0,0][0,0][0,0][0,0][0,0][0,0][0,0][0,0][0,0][0,0][0,0][0,0][0,0][0,0][0,0][0,0][0,0][0,0][0,0][0,0][0,0]
[0,0][0,1][0,0][0,0][0,0][0,0][0,0][0,0][0,0][0,0][0,0][0,0][0,0][0,0][0,0][0,0][0,0][0,0][0,0][0,0][0,0][0,0][0,0][0,0][0,0][0,0][0,0][0,0][0,0][0,0][0,0][0,0]
[0,0][0,1][0,0][0,0][0,0][0,0][0,0][0,0][0,0][0,0][0,0][0,0][0,0][0,0][0,0][0,0][0,0][0,0][0,0][0,0][0,0][0,0][0,0][0,0][0,0][0,0][0,0][0,0][0,0][0,0][0,0][0,0]
[0,0][0,1][0,0][0,0][0,0][0,0][0,0][0,0][0,0][0,0][0,0][0,0][0,0][0,0][0,0][0,0][0,0][0,0][0,0][0,0][0,0][0,0][0,0][0,0][0,0][0,0][0,0][0,0][0,0][0,0][0,0][0,0]
[0,0][1,0][0,1][0,0][0,0][0,0][0,0][0,0][0,0][0,0][0,0][0,0][0,0][0,0][0,0][0,0][0,0][0,0][0,0][0,0][0,0][0,0][0,0][0,0][0,0][0,0][0,0][0,0][0,0][0,0][0,0][0,0]
[0,0][0,0][0,1][0,0][0,0][0,0][0,0][0,0][0,0][0,0][0,0][0,0][0,0][0,0][0,0][0,0][0,0][0,0][0,0][0,0][0,0][0,0][0,0][0,0][0,0][0,0][0,0][0,0][0,0][0,0][0,0][0,0]
[0,0][0,0][1,0][1,0][1,0][1,0][0,1][0,0][0,0][0,0][0,0][0,0][0,0][0,0][0,0][0,0][0,0][0,0][0,0][0,0][0,0][0,0][0,0][0,0][0,0][0,0][0,0][0,0][0,0][0,0][0,0][0,0]
[0,0][0,0][0,0][0,0][0,0][0,0][0,1][0,0][0,0][0,0][0,0][0,0][0,0][0,0][0,0][0,0][0,0][0,0][0,0][0,0][0,0][0,0][0,0][0,0][0,0][0,0][0,0][0,0][0,0][0,0][0,0][0,0]
[0,0][0,0][0,0][0,0][0,0][0,0][0,1][0,0][0,0][0,0][0,0][0,0][0,0][0,0][0,0][0,0][0,0][0,0][0,0][0,0][0,0][0,0][0,0][0,0][0,0][0,0][0,0][0,0][0,0][0,0][0,0][0,0]
[0,0][0,0][0,0][0,1][-1,0][-1,0][-1,0][0,0][0,0][0,0][1,0][1,0][1,0][1,0][1,0][1,0][1,0][1,0][0,1][0,0][0,0][0,0][0,0][0,0][0,0][0,0][0,0][0,0][0,0][0,0][0,0][0,0]
[0,0][0,0][0,0][0,1][0,0][0,0][0,0][0,0][0,0][0,0][0,-1][0,0][0,0][0,0][0,0][0,0][0,0][0,0][0,1][0,0][0,0][0,0][0,0][0,0][0,0][0,0][0,0][0,0][0,0][0,0][0,0][0,0]
[0,0][0,0][0,0][0,1][0,0][0,0][0,0][0,0][0,0][0,0][0,-1][0,0][0,0][0,0][0,0][0,0][0,0][0,0][0,1][0,0][0,0][0,0][0,0][0,0][0,0][0,0][0,0][0,0][0,0][0,0][0,0][0,0]
[0,0][0,0][0,0][0,1][0,0][0,0][0,0][0,0][0,0][0,0][0,-1][0,0][0,0][0,0][0,0][0,0][0,0][0,0][1,0][1,0][1,0][1,0][1,0][1,0][1,0][0,1][0,0][0,0][0,0][0,0][0,0][0,0]
[0,0][0,0][0,0][1,0][1,0][1,0][1,0][1,0]1,0][1,0][0,-1][0,0][0,0][0,0][0,0][0,0][0,0][0,0][0,0][0,0][0,0][0,0][0,0][0,0][0,0][0,1][0,0][0,0][0,0][0,0][0,0][0,0]
[0,0][0,0][0,0][0,0][0,0][0,0][0,0][0,0][0,0][0,0][0,0][0,0][0,0][0,0][0,0][0,0][0,0][0,0][0,0][0,0][0,0][0,0][0,0][0,0][0,0][0,1][0,0][0,0][0,0][0,0][0,0][0,0]
[0,0][0,0][0,0][0,0][0,0][0,0][0,0][0,0][0,0][0,0][0,0][0,0][0,0][0,0][0,0][0,0][0,0][0,0][0,0][0,0][0,0][0,0][0,0][0,0][0,0][1,0][1,0][1,0][1,0][1,0][1,0][1,0]
[0,0][0,0][0,0][0,0][0,0][0,0][0,0][0,0][0,0][0,0][0,0][0,0][0,0][0,0][0,0][0,0][0,0][0,0][0,0][0,0][0,0][0,0][0,0][0,0][0,0][0,0][0,0][0,0][0,0][0,0][0,0][0,0]
[0,0][0,0][0,0][0,0][0,0][0,0][0,0][0,0][0,0][0,0][0,0][0,0][0,0][0,0][0,0][0,0][0,0][0,0][0,0][0,0][0,0][0,0][0,0][0,0][0,0][0,0][0,0][0,0][0,0][0,0][0,0][0,0]
[0,0][0,0][0,0][0,0][0,0][0,0][0,0][0,0][0,0][0,0][0,0][0,0][0,0][0,0][0,0][0,0][0,0][0,0][0,0][0,0][0,0][0,0][0,0][0,0][0,0][0,0][0,0][0,0][0,0][0,0][0,0][0,0]
[0,0][0,0][0,0][0,0][0,0][0,0][0,0][0,0][0,0][0,0][0,0][0,0][0,0][0,0][0,0][0,0][0,0][0,0][0,0][0,0][0,0][0,0][0,0][0,0][0,0][0,0][0,0][0,0][0,0][0,0][0,0][0,0]
[0,0][0,0][0,0][0,0][0,0][0,0][0,0][0,0][0,0][0,0][0,0][0,0][0,0][0,0][0,0][0,0][0,0][0,0][0,0][0,0][0,0][0,0][0,0][0,0][0,0][0,0][0,0][0,0][0,0][0,0][0,0][0,0]
[0,0][0,0][0,0][0,0][0,0][0,0][0,0][0,0][0,0][0,0][0,0][0,0][0,0][0,0][0,0][0,0][0,0][0,0][0,0][0,0][0,0][0,0][0,0][0,0][0,0][0,0][0,0][0,0][0,0][0,0][0,0][0,0]
[0,0][0,0][0,0][0,0][0,0][0,0][0,0][0,0][0,0][0,0][0,0][0,0][0,0][0,0][0,0][0,0][0,0][0,0][0,0][0,0][0,0][0,0][0,0][0,0][0,0][0,0][0,0][0,0][0,0][0,0][0,0][0,0]
[0,0][0,0][0,0][0,0][0,0][0,0][0,0][0,0][0,0][0,0][0,0][0,0][0,0][0,0][0,0][0,0][0,0][0,0][0,0][0,0][0,0][0,0][0,0][0,0][0,0][0,0][0,0][0,0][0,0][0,0][0,0][0,0]
[0,0][0,0][0,0][0,0][0,0][0,0][0,0][0,0][0,0][0,0][0,0][0,0][0,0][0,0][0,0][0,0][0,0][0,0][0,0][0,0][0,0][0,0][0,0][0,0][0,0][0,0][0,0][0,0][0,0][0,0][0,0][0,0]
[0,0][0,0][0,0][0,0][0,0][0,0][0,0][0,0][0,0][0,0][0,0][0,0][0,0][0,0][0,0][0,0][0,0][0,0][0,0][0,0][0,0][0,0][0,0][0,0][0,0][0,0][0,0][0,0][0,0][0,0][0,0][0,0]
[0,0][0,0][0,0][0,0][0,0][0,0][0,0][0,0][0,0][0,0][0,0][0,0][0,0][0,0][0,0][0,0][0,0][0,0][0,0][0,0][0,0][0,0][0,0][0,0][0,0][0,0][0,0][0,0][0,0][0,0][0,0][0,0]
[0,0][0,0][0,0][0,0][0,0][0,0][0,0][0,0][0,0][0,0][0,0][0,0][0,0][0,0][0,0][0,0][0,0][0,0][0,0][0,0][0,0][0,0][0,0][0,0][0,0][0,0][0,0][0,0][0,0][0,0][0,0][0,0]


;level 2
w32
h32
[0,0][0,0][0,0][0,0][0,0][0,0][0,0][0,0][0,0][0,0][0,0][0,0][0,0][0,0][0,0][0,0][0,0][0,0][0,0][0,0][0,0][0,0][0,0][0,0][0,0][0,0][0,0][0,0][0,0][0,0][0,0][0,0]
[1,0][0,1][0,0][0,0][0,0][0,0][0,0][0,0][0,0][0,0][0,0][0,0][0,0][0,0][0,0][0,0][0,0][0,0][0,0][0,0][0,0][0,0][0,0][0,0][0,0][0,0][0,0][0,0][0,0][0,0][0,0][0,0]
[0,0][0,1][0,0][0,0][0,0][0,0][0,0][0,0][0,0][0,0][0,0][0,0][0,0][0,0][0,0][0,0][0,0][0,0][0,0][0,0][0,0][0,0][0,0][0,0][0,0][0,0][0,0][0,0][0,0][0,0][0,0][0,0]
[0,0][0,1][0,0][0,0][0,0][0,0][0,0][0,0][0,0][0,0][0,0][0,0][0,0][0,0][0,0][0,0][0,0][0,0][0,0][0,0][0,0][0,0][0,0][0,0][0,0][0,0][0,0][0,0][0,0][0,0][0,0][0,0]
[0,0][0,1][0,0][0,0][0,0][0,0][0,0][0,0][0,0][0,0][0,0][0,0][0,0][0,0][0,0][0,0][0,0][0,0][0,0][0,0][0,0][0,0][0,0][0,0][0,0][0,0][0,0][0,0][0,0][0,0][0,0][0,0]
[0,0][0,1][0,0][0,0][0,0][0,0][0,0][0,0][0,0][0,0][0,0][0,0][0,0][0,0][0,0][0,0][0,0][0,0][0,0][0,0][0,0][0,0][0,0][0,0][0,0][0,0][0,0][0,0][0,0][0,0][0,0][0,0]
[0,0][0,1][0,0][0,0][0,0][0,0][0,0][0,0][0,0][0,0][0,0][0,0][0,0][0,0][0,0][0,0][0,0][0,0][0,0][0,0][0,0][0,0][0,0][0,0][0,0][0,0][0,0][0,0][0,0][0,0][0,0][0,0]
[0,0][0,1][0,0][0,0][0,0][0,0][0,0][0,0][0,0][0,0][0,0][0,0][0,0][0,0][0,0][0,0][0,0][0,0][0,0][0,0][0,0][0,0][0,0][0,0][0,0][0,0][0,0][0,0][0,0][0,0][0,0][0,0]
[0,0][1,0][0,1][0,0][0,0][0,0][0,0][0,0][0,0][0,0][0,0][0,0][0,0][0,0][0,0][0,0][0,0][0,0][0,0][0,0][0,0][0,0][0,0][0,0][0,0][0,0][0,0][0,0][0,0][0,0][0,0][0,0]
[0,0][0,0][0,1][0,0][0,0][0,0][0,0][0,0][0,0][0,0][0,0][0,0][0,0][0,0][0,0][0,0][0,0][0,0][0,0][0,0][0,0][0,0][0,0][0,0][0,0][0,0][0,0][0,0][0,0][0,0][0,0][0,0]
[0,0][0,0][1,0][1,0][1,0][1,0][0,1][0,0][0,0][0,0][0,0][0,0][0,0][0,0][0,0][0,0][0,0][0,0][0,0][0,0][0,0][0,0][0,0][0,0][0,0][0,0][0,0][0,0][0,0][0,0][0,0][0,0]
[0,0][0,0][0,0][0,0][0,0][0,0][0,1][0,0][0,0][0,0][0,0][0,0][0,0][0,0][0,0][0,0][0,0][0,0][0,0][0,0][0,0][0,0][0,0][0,0][0,0][0,0][0,0][0,0][0,0][0,0][0,0][0,0]
[0,0][0,0][0,0][0,0][0,0][0,0][0,1][0,0][0,0][0,0][0,0][0,0][0,0][0,0][0,0][0,0][0,0][0,0][0,0][0,0][0,0][0,0][0,0][0,0][0,0][0,0][0,0][0,0][0,0][0,0][0,0][0,0]
[0,0][0,0][0,0][0,1][-1,0][-1,0][-1,0][0,0][0,0][0,0][1,0][1,0][1,0][1,0][1,0][1,0][1,0][1,0][0,1][0,0][0,0][0,0][0,0][0,0][0,0][0,0][0,0][0,0][0,0][0,0][0,0][0,0]
[0,0][0,0][0,0][0,1][0,0][0,0][0,0][0,0][0,0][0,0][0,-1][0,0][0,0][0,0][0,0][0,0][0,0][0,0][0,1][0,0][0,0][0,0][0,0][0,0][0,0][0,0][0,0][0,0][0,0][0,0][0,0][0,0]
[0,0][0,0][0,0][0,1][0,0][0,0][0,0][0,0][0,0][0,0][0,-1][0,0][0,0][0,0][0,0][0,0][0,0][0,0][0,1][0,0][0,0][0,0][0,0][0,0][0,0][0,0][0,0][0,0][0,0][0,0][0,0][0,0]
[0,0][0,0][0,0][0,1][0,0][0,0][0,0][0,0][0,0][0,0][0,-1][0,0][0,0][0,0][0,0][0,0][0,0][0,0][1,0][1,0][1,0][1,0][1,0][1,0][1,0][0,1][0,0][0,0][0,0][0,0][0,0][0,0]
[0,0][0,0][0,0][1,0][1,0][1,0][1,0][1,0]1,0][1,0][0,-1][0,0][0,0][0,0][0,0][0,0][0,0][0,0][0,0][0,0][0,0][0,0][0,0][0,0][0,0][0,1][0,0][0,0][0,0][0,0][0,0][0,0]
[0,0][0,0][0,0][0,0][0,0][0,0][0,0][0,0][0,0][0,0][0,0][0,0][0,0][0,0][0,0][0,0][0,0][0,0][0,0][0,0][0,0][0,0][0,0][0,0][0,0][0,1][0,0][0,0][0,0][0,0][0,0][0,0]
[0,0][0,0][0,0][0,0][0,0][0,0][0,0][0,0][0,0][0,0][0,0][0,0][0,0][0,0][0,0][0,0][0,0][0,0][0,0][0,0][0,0][0,0][0,0][0,0][0,0][1,0][1,0][1,0][1,0][1,0][1,0][1,0]
[0,0][0,0][0,0][0,0][0,0][0,0][0,0][0,0][0,0][0,0][0,0][0,0][0,0][0,0][0,0][0,0][0,0][0,0][0,0][0,0][0,0][0,0][0,0][0,0][0,0][0,0][0,0][0,0][0,0][0,0][0,0][0,0]
[0,0][0,0][0,0][0,0][0,0][0,0][0,0][0,0][0,0][0,0][0,0][0,0][0,0][0,0][0,0][0,0][0,0][0,0][0,0][0,0][0,0][0,0][0,0][0,0][0,0][0,0][0,0][0,0][0,0][0,0][0,0][0,0]
[0,0][0,0][0,0][0,0][0,0][0,0][0,0][0,0][0,0][0,0][0,0][0,0][0,0][0,0][0,0][0,0][0,0][0,0][0,0][0,0][0,0][0,0][0,0][0,0][0,0][0,0][0,0][0,0][0,0][0,0][0,0][0,0]
[0,0][0,0][0,0][0,0][0,0][0,0][0,0][0,0][0,0][0,0][0,0][0,0][0,0][0,0][0,0][0,0][0,0][0,0][0,0][0,0][0,0][0,0][0,0][0,0][0,0][0,0][0,0][0,0][0,0][0,0][0,0][0,0]
[0,0][0,0][0,0][0,0][0,0][0,0][0,0][0,0][0,0][0,0][0,0][0,0][0,0][0,0][0,0][0,0][0,0][0,0][0,0][0,0][0,0][0,0][0,0][0,0][0,0][0,0][0,0][0,0][0,0][0,0][0,0][0,0]
[0,0][0,0][0,0][0,0][0,0][0,0][0,0][0,0][0,0][0,0][0,0][0,0][0,0][0,0][0,0][0,0][0,0][0,0][0,0][0,0][0,0][0,0][0,0][0,0][0,0][0,0][0,0][0,0][0,0][0,0][0,0][0,0]
[0,0][0,0][0,0][0,0][0,0][0,0][0,0][0,0][0,0][0,0][0,0][0,0][0,0][0,0][0,0][0,0][0,0][0,0][0,0][0,0][0,0][0,0][0,0][0,0][0,0][0,0][0,0][0,0][0,0][0,0][0,0][0,0]
[0,0][0,0][0,0][0,0][0,0][0,0][0,0][0,0][0,0][0,0][0,0][0,0][0,0][0,0][0,0][0,0][0,0][0,0][0,0][0,0][0,0][0,0][0,0][0,0][0,0][0,0][0,0][0,0][0,0][0,0][0,0][0,0]
[0,0][0,0][0,0][0,0][0,0][0,0][0,0][0,0][0,0][0,0][0,0][0,0][0,0][0,0][0,0][0,0][0,0][0,0][0,0][0,0][0,0][0,0][0,0][0,0][0,0][0,0][0,0][0,0][0,0][0,0][0,0][0,0]
[0,0][0,0][0,0][0,0][0,0][0,0][0,0][0,0][0,0][0,0][0,0][0,0][0,0][0,0][0,0][0,0][0,0][0,0][0,0][0,0][0,0][0,0][0,0][0,0][0,0][0,0][0,0][0,0][0,0][0,0][0,0][0,0]
[0,0][0,0][0,0][0,0][0,0][0,0][0,0][0,0][0,0][0,0][0,0][0,0][0,0][0,0][0,0][0,0][0,0][0,0][0,0][0,0][0,0][0,0][0,0][0,0][0,0][0,0][0,0][0,0][0,0][0,0][0,0][0,0]
[0,0][0,0][0,0][0,0][0,0][0,0][0,0][0,0][0,0][0,0][0,0][0,0][0,0][0,0][0,0][0,0][0,0][0,0][0,0][0,0][0,0][0,0][0,0][0,0][0,0][0,0][0,0][0,0][0,0][0,0][0,0][0,0]

;level 4
w32
h32
[0,0][0,0][0,0][0,0][0,0][0,0][0,0][0,0][0,0][0,0][0,0][0,0][0,0][0,0][0,0][0,0][0,0][0,0][0,0][0,0][0,0][0,0][0,0][0,0][0,0][0,0][0,0][0,0][0,0][0,0][0,0][0,0]
[1,0][0,1][0,0][0,0][0,0][0,0][0,0][0,0][0,0][0,0][0,0][0,0][0,0][0,0][0,0][0,0][0,0][0,0][0,0][0,0][0,0][0,0][0,0][0,0][0,0][0,0][0,0][0,0][0,0][0,0][0,0][0,0]
[0,0][0,1][0,0][0,0][0,0][0,0][0,0][0,0][0,0][0,0][0,0][0,0][0,0][0,0][0,0][0,0][0,0][0,0][0,0][0,0][0,0][0,0][0,0][0,0][0,0][0,0][0,0][0,0][0,0][0,0][0,0][0,0]
[0,0][0,1][0,0][0,0][0,0][0,0][0,0][0,0][0,0][0,0][0,0][0,0][0,0][0,0][0,0][0,0][0,0][0,0][0,0][0,0][0,0][0,0][0,0][0,0][0,0][0,0][0,0][0,0][0,0][0,0][0,0][0,0]
[0,0][0,1][0,0][0,0][0,0][0,0][0,0][0,0][0,0][0,0][0,0][0,0][0,0][0,0][0,0][0,0][0,0][0,0][0,0][0,0][0,0][0,0][0,0][0,0][0,0][0,0][0,0][0,0][0,0][0,0][0,0][0,0]
[0,0][0,1][0,0][0,0][0,0][0,0][0,0][0,0][0,0][0,0][0,0][0,0][0,0][0,0][0,0][0,0][0,0][0,0][0,0][0,0][0,0][0,0][0,0][0,0][0,0][0,0][0,0][0,0][0,0][0,0][0,0][0,0]
[0,0][0,1][0,0][0,0][0,0][0,0][0,0][0,0][0,0][0,0][0,0][0,0][0,0][0,0][0,0][0,0][0,0][0,0][0,0][0,0][0,0][0,0][0,0][0,0][0,0][0,0][0,0][0,0][0,0][0,0][0,0][0,0]
[0,0][0,1][0,0][0,0][0,0][0,0][0,0][0,0][0,0][0,0][0,0][0,0][0,0][0,0][0,0][0,0][0,0][0,0][0,0][0,0][0,0][0,0][0,0][0,0][0,0][0,0][0,0][0,0][0,0][0,0][0,0][0,0]
[0,0][0,1][0,0][0,0][0,0][0,0][0,0][0,0][0,0][0,0][0,0][0,0][0,0][0,0][0,0][0,0][0,0][0,0][0,0][0,0][0,0][0,0][0,0][0,0][0,0][0,0][0,0][0,0][0,0][0,0][0,0][0,0]
[0,0][0,1][0,0][0,0][0,0][0,0][0,0][0,0][0,0][0,0][0,0][0,0][0,0][0,0][0,0][0,0][0,0][0,0][0,0][0,0][0,0][0,0][0,0][0,0][0,0][0,0][0,0][0,0][0,0][0,0][0,0][0,0]
[0,0][0,1][0,0][0,0][1,0][1,0][0,1][0,0][0,0][0,0][0,0][0,0][0,0][0,0][0,0][0,0][0,0][0,0][0,0][0,0][0,0][0,0][0,0][0,0][0,0][0,0][0,0][0,0][0,0][0,0][0,0][0,0]
[0,0][0,1][0,0][0,0][0,-1][0,0][0,1][0,0][0,0][0,0][0,0][0,0][0,0][0,0][0,0][0,0][0,0][0,0][0,0][0,0][0,0][0,0][0,0][0,0][0,0][0,0][0,0][0,0][0,0][0,0][0,0][0,0]
[0,0][0,1][0,0][0,0][0,-1][0,0][0,1][0,0][0,0][0,0][0,0][0,0][0,0][0,0][0,0][0,0][0,0][0,0][0,0][0,0][0,0][0,0][0,0][0,0][0,0][0,0][0,0][0,0][0,0][0,0][0,0][0,0]
[0,0][0,1][0,0][0,0][0,-1][0,0][0,1][0,0][0,0][1,0][1,0][1,0][1,0][1,0][1,0][1,0][1,0][1,0][0,1][0,0][0,0][0,0][0,0][0,0][0,0][0,0][0,0][0,0][0,0][0,0][0,0][0,0]
[0,0][0,1][0,0][0,0][0,-1][0,0][0,1][0,0][0,0][0,-1][0,0][0,0][0,0][0,0][0,0][0,0][0,0][0,0][0,1][0,0][0,0][0,0][0,0][0,0][0,0][0,0][0,0][0,0][0,0][0,0][0,0][0,0]
[0,0][0,1][0,0][0,0][0,-1][0,0][0,1][0,0][0,0][0,-1][0,0][0,0][0,0][0,0][0,0][0,0][0,0][0,0][0,1][0,0][0,0][0,0][0,0][0,0][0,0][0,0][0,0][0,0][0,0][0,0][0,0][0,0]
[0,0][0,1][0,0][0,0][0,-1][0,0][0,1][0,0][0,0][0,-1][0,0][0,0][0,0][0,0][0,0][0,0][0,0][0,0][1,0][1,0][1,0][1,0][1,0][1,0][1,0][0,1][0,0][0,0][0,0][0,0][0,0][0,0]
[0,0][0,1][0,0][0,0][0,-1][0,0][0,1][0,0][0,0][0,-1][0,0][0,0][0,0][0,0][0,0][0,0][0,0][0,0][0,0][0,0][0,0][0,0][0,0][0,0][0,0][0,1][0,0][0,0][0,0][0,0][0,0][0,0]
[0,0][0,1][0,0][0,0][0,-1][0,0][0,1][0,0][0,0][0,-1][0,0][0,0][0,0][0,0][0,0][0,0][0,0][0,0][0,0][0,0][0,0][0,0][0,0][0,0][0,0][0,1][0,0][0,0][0,0][0,0][0,0][0,0]
[0,0][0,1][0,0][0,0][0,-1][0,0][0,1][0,0][0,0][0,-1][0,0][0,0][0,0][0,0][0,0][0,0][0,0][0,0][0,0][0,0][0,0][0,0][0,0][0,0][0,0][1,0][1,0][1,0][1,0][1,0][1,0][1,0]
[0,0][0,1][0,0][0,0][0,-1][0,0][0,1][0,0][0,0][0,-1][0,0][0,0][0,0][0,0][0,0][0,0][0,0][0,0][0,0][0,0][0,0][0,0][0,0][0,0][0,0][0,0][0,0][0,0][0,0][0,0][0,0][0,0]
[0,0][0,1][0,0][0,0][0,-1][0,0][0,1][0,0][0,0][0,-1][0,0][0,0][0,0][0,0][0,0][0,0][0,0][0,0][0,0][0,0][0,0][0,0][0,0][0,0][0,0][0,0][0,0][0,0][0,0][0,0][0,0][0,0]
[0,0][0,1][0,0][0,0][0,-1][0,0][0,1][0,0][0,0][0,-1][0,0][0,0][0,0][0,0][0,0][0,0][0,0][0,0][0,0][0,0][0,0][0,0][0,0][0,0][0,0][0,0][0,0][0,0][0,0][0,0][0,0][0,0]
[0,0][0,1][0,0][0,0][0,-1][0,0][0,1][0,0][0,0][0,-1][0,0][0,0][0,0][0,0][0,0][0,0][0,0][0,0][0,0][0,0][0,0][0,0][0,0][0,0][0,0][0,0][0,0][0,0][0,0][0,0][0,0][0,0]
[0,0][0,1][0,0][0,0][0,-1][0,0][1,0][1,0][1,0][0,-1][0,0][0,0][0,0][0,0][0,0][0,0][0,0][0,0][0,0][0,0][0,0][0,0][0,0][0,0][0,0][0,0][0,0][0,0][0,0][0,0][0,0][0,0]
[0,0][0,1][0,0][0,0][0,-1][0,0][0,0][0,0][0,0][0,0][0,0][0,0][0,0][0,0][0,0][0,0][0,0][0,0][0,0][0,0][0,0][0,0][0,0][0,0][0,0][0,0][0,0][0,0][0,0][0,0][0,0][0,0]
[0,0][0,1][0,0][0,0][0,-1][0,0][0,0][0,0][0,0][0,0][0,0][0,0][0,0][0,0][0,0][0,0][0,0][0,0][0,0][0,0][0,0][0,0][0,0][0,0][0,0][0,0][0,0][0,0][0,0][0,0][0,0][0,0]
[0,0][0,1][0,0][0,0][0,-1][0,0][0,0][0,0][0,0][0,0][0,0][0,0][0,0][0,0][0,0][0,0][0,0][0,0][0,0][0,0][0,0][0,0][0,0][0,0][0,0][0,0][0,0][0,0][0,0][0,0][0,0][0,0]
[0,0][0,1][0,0][0,0][0,-1][0,0][0,0][0,0][0,0][0,0][0,0][0,0][0,0][0,0][0,0][0,0][0,0][0,0][0,0][0,0][0,0][0,0][0,0][0,0][0,0][0,0][0,0][0,0][0,0][0,0][0,0][0,0]
[0,0][1,0][1,0][1,0][0,-1][0,0][0,0][0,0][0,0][0,0][0,0][0,0][0,0][0,0][0,0][0,0][0,0][0,0][0,0][0,0][0,0][0,0][0,0][0,0][0,0][0,0][0,0][0,0][0,0][0,0][0,0][0,0]
[0,0][0,0][0,0][0,0][0,0][0,0][0,0][0,0][0,0][0,0][0,0][0,0][0,0][0,0][0,0][0,0][0,0][0,0][0,0][0,0][0,0][0,0][0,0][0,0][0,0][0,0][0,0][0,0][0,0][0,0][0,0][0,0]
[0,0][0,0][0,0][0,0][0,0][0,0][0,0][0,0][0,0][0,0][0,0][0,0][0,0][0,0][0,0][0,0][0,0][0,0][0,0][0,0][0,0][0,0][0,0][0,0][0,0][0,0][0,0][0,0][0,0][0,0][0,0][0,0]
